=====================?========
=@============================
######|||#####################
===============|===|==========
===============|===|======*===
=======^^^#====|===|==========
===============|===|=========&
##############################