==============================
=@===========================&
=#===========================*
====##=========^===|======#===
=========##====|===|=====##===
===============|===|====###===
##############################