==============================
=============================&
======================^##^====
===============|===|==========
===============|===|==========
=@=============|===|==========
##############################