==============================
==============================
==============#########=======
==============#=============*
==============#=*===###=======
==============###=====#=======
=====================*#=======
====================###=======
=@==================#========&
################====##########