==============================
=@===================?========
######|||#####################
===============|===|==========
===============|===|======*===
=======^^^#====|===|==========
===============|===|=========&
##############################