=@============================
#####==#######################
==============================
###########==#################
==============================
#######==#####################
==============================
################==############
==============================
####################|||||#####
================&=============
##############################